EEEEEEEEEEEEEEEEEEEE
EGGGA:AGGGGGGGGGGGGE
EGGGAGAGGGGGGGGGGGGE
EGGGGGGGGGGGGGGGGGGE
EGGGGGGGGGGGGGGGGG;E
EGGGG5GGGGGGGGGGGGAE
EGGGGGGGGGGGGGGGGGAE
E;GGGGGGGGMGGGGGGGAE
EAGGGGGGGGGGGGGGGGGE
EEEEEEEEGGGGGGGGGGGE
EGGGGGMEEGGEEEEEEEEE
EGGGGGGGEGG5GGEEEEEE
EGGGGGGGGGGGGGEEEEEE
EGGGGGGGEGGGGGEEEEEE
EGGGGGGGEGGGGGEEEEEE
EEEEEEEEEEEEEEEEEEEE
