4VVVVVVVVVV4
4GGGGGGGGG>4
4GGGGGGGGGG4
4GG=GGGGGGG4
4GGGGGG>GGG4
4GGGGGGGGGG4
4GGGGGGGGGO4
4GGGGGGGGGG4
4G=GGGGGGG>4
VVVVVVVVVVVV
$
0 0 10 5 22 24
0 1 6 10 6 8
