4VVVVVVVVVV4
4GGGGGGGGGG4
4GGGGGGGGGG4
4GGGGGGGGGG4
4GGGGGGGGGG4
4GGGGGGGGGG4
4GGGGGGGGGO4
4GGGGGGGGGG4
4GGGGGGGGGG4
VVVVVVVVVVVV
$
0 0 10 5 22 24
0 1 6 10 6 8
