RRRRRRRRRRRR
RRRRRRQRRRRR
RRRRRRRRRRRR
RRRRRRRRRRRR
RRPRRRRRRRRR
RRRRRRRRRRRR
RRRRARMRARRR
RRRRRRRRRRRR
RRRRRRRRRRRR
RRRRRXRRRRRR
