444444444444
4GGGGGGGGGG4
4GGGGGGGGGG4
4GGGGGGGGGG4
4GGGGGGGGGO4
4GGGGGGGGGG4
4GGGGGGGGGG4
4GGGGGGGGGG4
4GGGGGGGGGG4
44444:444444
