RRRRRRRRRRRR
RRRRRRRRRRRR
RRRRRRRRRRRR
RRRR;RRR;RRR
RRRRSRRRSRRR
RRRRSRRRSRRR
RRRRRRRRRRRR
RRRRRRRRRRRR
RRRRRRRRRRRR
RRRRRRRRRRRR
