RRRRRRRRRRRR
RRRRRRRRRRRR
RRRRR//RRRRR
RRRR;RRR;RRR
RRRRSRRRSRRR
RR.RSRRRSRRR
RRRRRRRRRRRR
RRRRRRRRRRRR
RRRRRRRRRRRR
RRRRRRRRRRRR
