777777444444444477777777777777
777777444444444477777777777777
777777444444444477777770111127
777777444444444477777776777787
777777GGGGGGGGGG7777777<====>7
77777777777777777777777CCCCCC7
777777777777777777777777777777
777777778777677777777777777777
777777778777677777777777777777
========>777<=================
CCCCCCCCC777CCCCCCCCCCCCCCCCCC
HHHHHHHHH77777777HHHHHHHHHHHHH
HHHHHHHHH77777777777HHHHHHHHHH
IHHHHHHHH7777777777777HHHHHHHH
HHHHHHH77777777777777777HHHHHI
HHHHH7777777777777777777777HHI
HHHH77777777777777777777777777
HHH777777777777777777777777777
HH7777777777777777777777777777
H77777777777777777777777777777
H77777777777777777777777777777
7777777777777777GGG77777777777
7777777777777777GGG77777777777
7777JNNNNJ777777GGG77777777777
7777JLLLLJ77777777777777777777
7777JLLLLJ77777777777777777777
7777JLLKLJ77777777777777777777
7777JLLLLJ77777777777777777777
7777NNNNNN77777777777777777777
777777777777777777777777777777
$
0 0 4 10 9 5
0 3 24 8 0 0
