777777777777777777777777777777
777777777777777777777777777777
777777777777777777777777777777
777777777777777777777777777777
777777777777777777777777777777
777777777777777777777777777777
777777777777777444444447777777
777777777777777444444447777777
777777777777777444444447777777
77777777777777GVVVVVVVVG777777
77777777777777GVVVVVVVVG777777
77777777777777GVVVVVVVVG777777
77777777777777GGGGGGGGGG777777
777777777777777777UU7777777777
777777777777777777UU7777777777
777777777777777777UU7777777777
777777777777777777UU7777777777
77777JJJJJJJ777777UU7777777777
77777JJJJJJJ777777UU7777777777
77777NNNNNNN777777UU7777777777
77777WWWWWWW777777UU7777777777
77777WWWWWWW7777UUUU7777777777
7777777UUUUUUUUUUU777777777777
77777777UUUUUUUU77777777777777
77777777777UUUU777777777777777
777777777777UUU777777777777777
777777777777UUU777777777777777
777777777777UUU777777777777777
777777777777UUU777777777777777
777777777777UUU777777777777777
$
