RRRRRRRRRRRRRRRRRRRRRRRRRRRRRR
RRRRRRRRRRRRRRRRRRRRRRRRRRRRRR
RRRRRRRRRRRRRRRRRRRRRRRRRRRRRR
RRRRRRRRRRRRRRRRRRRRRRRRRRRRRR
RRRRRRRR7RRRRRRRRRRRRRRRRRRRRR
RRRRRRRRRRRRRRR;RRRRRR;RRRRRRR
RRRRRZRRRRRRRR;RRRRRRRR;RRRRRR
RRRRRRRRRRRRRR;RRRRRRRR;RRRRRR
RRRRRRRRZRRRRR;RRRRRRRR;RRRRRR
RRRRRRRRRRRRRRS;RRRRRR;SRRRRRR
RRRRRRRRRRRRRRSSRRRRRRSSRRRRRR
RRRRRRRRRRRRRRASRR:?RRSARRRRRR
RRRRZRRRRRRRRRRARRRRRRARRRRRRR
RRRRRRRRRRRRRRRRRRRRRRRRRRRRRR
RRRRRRRRRRRRRRRRRRRRRRRRRRRRRR
RRRRRRRRRRRRRRRRRRRRRRRRRRRRRR
RRRRRRRRRRRRRRRRRRRRRRRRRRRRRR
RRRRRRRRRRRRRRRRRRRRRRRRRRRRRR
RRRRRRYYYYYRRRRRZRRRRRRRRRRRRR
RRRRRRYYYYYRRRRZRZRRRZRRRRRRRR
RRRRRRYYYYYRRRRRRRRRRRRRRRRRRR
RRRRRRRR:?RRRRRRRRRRRRRRRRRRRR
RRRRRRRRRRRRRRRRRRRRRRRRRRRRRR
RRRRRRRRRRRRRRRRRRRRRRRRRRRRRR
RRRRRRRRRRRRRRRRRRRRRRRRRRRRRR
RRRRRRRRRRRRRRRRRRRRRRRRRRRRRR
RRRRRRRRRRRRRRRRRRRRRRRRRRRRRR
RRRRRRRRRRRRRRRRRRRRRRRRRRRRRR
RRRRRRRRRRRRRRRRRRRRRRRRRRRRRR
RRRRRRRRRRRRRRRRRRRRRRRRRRRRRR
