EEEEEEEEEEE
EGGGGGGGGGE
EGGGGGGGGGE
EGGGGGGGGGE
EGGGGGGGGGE
EGGGGGGGGGE
EGGGGGGGGOE
EGGGGGGGGGE
EGGGGGGGGGE
EGGGGGGGGGE
EEEEEEEEEEE
