777@@@@@77777HHH77777JJJJJ7777
777@@@@@77777HHHo7777JJJJJ7777
777@@@@@77777HHHIo777JJJJJ7777
777@@@@@77777HHHHHo77JJJJJ7777
777_UUUUd77777HHHHH7eUUUU^7777
7777_UUUUUd7777eUHHUUUUU^77777
777777_UUUUUUUUUUHHU^777777777
7777777777_UUUU^7IHooo77777777
77777777777_UU777IIIHHoooooooo
777777777777UU777IIIHHHHHHHHHH
777777777777UU77777IIHHHHHHHHH
777777777777UU7777777777777777
777777777777UU7777777777777777
77777777777eUU7777777777777777
7777777777UUUU7777777777777777
7777777777UUUU7777777444444447
777777777777UU7777777444444447
777777777777UU7777777444444447
777777777777UUd777777444444447
777777777777UUUUUUUUd444444447
777777777777UUUUUUUUU444444447
7777777777eUUU^777_UU444444447
77777777eUUUU^77777_UUUUUU^777
7777eUUUUUUU^7777777_UUUU^7777
UUUUUUUUU^77777777777777777777
UUUUUUU^7777777777777777777777
777777777777777777777777777777
777777777777777777777777777777
777777777777777777777777777777
777777777777777777777777777777
$
0 4 3 5 20 8
0 1 3 23 10 4
0 2 21 24 10 5
