777@@@@@7777777777777JJJJJ7777
777@@@@@7777777777777JJJJJ7777
777@@@@@7777777777777JJJJJ7777
777@@@@@7777777777777JJJJJ7777
7777UUUU7777777777777UUUUU7777
77777UUUUU777777UUUUUUUUU77777
7777777UUUUUUUUUUUUUU777777777
777777777UUUUUUU77777777777777
7777777777UUUUU777777777777777
77777777777UUUU777777777777777
777777777777UU7777777777777777
777GGGGGGG77UU7777777777777777
777GEEEEEG77UU7777777777777777
777GEIIIEG77UU7777777777777777
777GEIIIEGUUUU7777777777777777
777GEIIIEGUUUU7777777444444447
777GEEEEEG77UU7777777444444447
777GGGGGGG77UU77777GG44444444G
777777777777UUU7777GG44444444G
777777777777UUUUUUUGG44444444G
777777777777UUUUUUUGG44444444G
7777777777UUUUU7777GG44444444G
77777777UUUUUU77777GGGGGGGGGGG
7777UUUUUUUU7777777GGGGGGGGGGG
UUUUUUUUU777777777777777777777
UUUUUUUU7777777777777777777777
777777777777777777777777777777
777777777777777777777777777777
777777777777777777777777777777
777777777777777777777777777777
$
0 4 3 5 20 8
0 1 3 23 10 4
0 2 21 24 10 5
