RRRRRRRR[RRRRRRRRRRRRRRRRR[RRR
RRRRRRRR[RRRRRRRRRRRRRRRRR[RRR
RRR[[[[[[RRRRRRRRRRRR[[[[[[RRR
RRR[[[[[[RRRRTRRRRRRR[[[[[[RRR
RRR[[[[[[RRTRRRRRRRRR[[[[[[RRR
RRRRRRRRRRRRRRRRRRRRRRRRRRRRRR
RRRRRRRRRRRRRRRRRRRRRRRRRRRRRR
RRRRRRRRRRRRRRRRRRRRRRRRRRRRRR
RRRRRRRRRRRRRRRRRRTRRRRRRRRRRR
RRRRRRRRRRRRRRRRRRRRRRRRRRRRRR
RRRRRRRRRRRRRRRRRRRRRRTRRRRRRR
RRRRRR;RRRRRRRRRRRRRRRRRRRRRRR
RRRRRRSRRRRRRRRTRRRRRRRRRRRRRR
RRRRRRSRRRRRRRRRRRRRRRRRRRRRRR
RRRRRRRRRRRRRRRRR/.RRRRRRRRRRR
RRRRRRRRRRRRRRRRRRRRRRRRRRRRRR
RRRRRRRRRRRRRRRRRRRRRRRRRRRRRR
RRRRRRRRRRRRRRRRRRRRRRRRRRRRR[
RRRRRRRRRRRRRRRRRRRRRRRRRRRRR[
RRRRRRRRRRRRRRRRRRRRR[[[[[[[[[
RRRRRRRRRRRRRRRRRRRRR[[[[[[[[[
RRRRRRRTRRRRRRRRRRRRR[[[[[[[[[
RRRRRRRRRRRRRRRRRRRRR[[[[[[[[[
RRRRRRRRRRRRRRRRTRRRRRRRRRRRRR
RRRRRRRRRRRRRRRRRRRRRRRRRRRRRR
RRRRRRRRRRRRRRRRRRRRRRRRRRRRRR
RRRRRRRRRRRRRRRRRRRRRRRRRRRRRR
RRRRRRRRRRRRRRRRRRRRRRRRRRRRRR
RRRRRRRRRRRRRRRRRRRRRRRRRRRRRR
RRRRRRRRRRRRRRRRRRRRRRRRRRRRRR
