RRRRRRRR[RRRRRRRRRRRRRRRRR[RRR
RRRRRRRR[RRRRRRRRRRRRRRRRR[RRR
RRR[[[[[[RRRRRRRRRRRR[[[[[[RRR
RRR[[[[[[RRRRTRRRRRRR[[[[[[RRR
RRR[[[[[[RRTRRRRRRRRR[[[[[[RRR
RRRRRRRRRRRRRRRRRRRRRRRRRRRRRR
RRRRRRRRRRRRRRRRRRRRRRRRRRRRRR
RRRRRRRRRRRRRRRRR[[RRRRRRRRRRR
RRRRRRRRRRRRRRRRRRRRRRRRRRRRRR
RRRRRRRRRRRRRRRRRRTRRRRRRRRRRR
RRRRRRRRRRR-RRRR,RRRRRTRRRRRRR
RRRRRRRRRRRRRRRRRRRRRRRRRRRRRR
RRRR`aRRRRRRRRRTRRR`aRRRRRRRRR
RRRRRRRRRRRRRRRRRRRRRRRRRRRRRR
RRRRRRRRRRRRRRRRR/.RRRRRRRRRRR
RRRRRRRRRRRRRRRRRRRRRRRRRRRRRR
RRRRRRRRRRRRRRRRRRRRRRRRRRRRRR
RRRRRRRRRRRRRRRRRRRRRRRRRRRRR[
RRRRRRRRRRRRRRRRRRRRRRRRRRRRR[
RRRRRRRRR`aRRRRRRRRRR[[[[[[[[[
RRRRRRRRRRRRRRRRRRRRR[[[[[[[[[
RRRRRRRTRRRRRRRRRRRRR[[[[[[[[[
RRRRRRRRRRRRRRRRRRRRR[[[[[[[[[
RRRRRRRRRRRRRRRRTRRRRRR+RRRRRR
RRRRRRRRRRRRRRRRRRRRRRRRRRRRRR
RRRRRRRRRRRRRRRRRRRRRRRRRRRRRR
RRRRRRRRRRRRRRRRRRRRRRRRRRRRRR
RRRRRRRRRRRRRRRRRRRRRRRRRRRRRR
RRRRRRRRRRRRRRRRRRRRRRRRRRRRRR
RRRRRRRRRRRRRRRRRRRRRRRRRRRRRR
