RRRRRRRR[RRRRRRRRRRRRRRRRR[RRR
RRRRRRRR[RRRRRRRRRRRRRRRRR[RRR
RRR[[[[[[RRRRRRRRRRRR[[[[[[RRR
RRR[[[[[[RRRRRRRRRRRR[[[[[[RRR
RRR[[[[[[RRRRRRRRRRRR[[[[[[RRR
RRRRRRRRRRRRRRRRRRRRRRRRRRRRRR
RRRRRRRRRRRRRRRRRRRRRRRRRRRRRR
RRRRRRRRRRRRRRRRRRRRRRRRRRRRRR
RRRRRRRRRRRRRRRRRRRRRRRRRRRRRR
RRRRRRRRRRRRRRRRRRRRRRRRRRRRRR
RRRRRRRRRRRRRRRRRRRRRRRRRRRRRR
RRRRRR;RRRRRRRRRRRRRRRRRRRRRRR
RRRRRRSRRRRRRRRRRRRRRRRRRRRRRR
RRRRRRSRRRRRRRRRRRRRRRRRRRRRRR
RRRRRRRRRRRRRRRRR/.RRRRRRRRRRR
RRRRRRRRRRRRRRRRRRRRRRRRRRRRRR
RRRRRRRRRRRRRRRRRRRRRRRRRRRRRR
RRRRRRRRRRRRRRRRRRRRRRRRRRRRR[
RRRRRRRRRRRRRRRRRRRRRRRRRRRRR[
RRRRRRRRRRRRRRRRRRRRR[[[[[[[[[
RRRRRRRRRRRRRRRRRRRRR[[[[[[[[[
RRRRRRRRRRRRRRRRRRRRR[[[[[[[[[
RRRRRRRRRRRRRRRRRRRRR[[[[[[[[[
RRRRRRRRRRRRRRRRRRRRRRRRRRRRRR
RRRRRRRRRRRRRRRRRRRRRRRRRRRRRR
RRRRRRRRRRRRRRRRRRRRRRRRRRRRRR
RRRRRRRRRRRRRRRRRRRRRRRRRRRRRR
RRRRRRRRRRRRRRRRRRRRRRRRRRRRRR
RRRRRRRRRRRRRRRRRRRRRRRRRRRRRR
RRRRRRRRRRRRRRRRRRRRRRRRRRRRRR
