RRRRRRRRRRRRRRRRRRRRRRRRRRRRRR
R2RRRRRRRRRRRRRRRR2RRRRRRRRRRR
RRRRRRRRRR<RRRRRRRRRRRRRR\RRRR
RRRRR:?RRRR3RRRRRRRRRR?:0\R1RR
RRRRRRRRRR1RRZRRRRRRRRRRRRRR2R
RRRRRRRRRRRZRRRRlmmnRRRRRRR2RR
RRRRRRRRRRRRRRRRrsstRRRRRRRRRR
RR1RRRRR1RRRRRRRRRRRRRRR8RRRRR
RRRRR1RRRRRRRRRRRRRRRRRRRRRRRR
RRRRRRRRRRRRRRRR1RRRRRRRRRRRRR
R8RRRR2RRRRRRR1RRRZRRRRRRRRRRR
RRRRRRRRRRRRRRRRRRRRRRZRRRRRRR
R2RRRR6R1RRRRRRRR2RRRRRR8RR1RR
RRR<fgRRRRRRRRRZRRRfgR8RRRRRRR
RRRRRc]cRRRRRRRRRR32RRRRRR2RRR
RRRRRcRRRRRRRRRRRRRRRRRRRRRRRR
R2R6RRRR<RRRRRRRR1RRRRRRRRRRRR
RRRR1RRR1RRRRR<RRRRRRRRRRRRRRR
RRRRRRRRRRRRRRRRRRRRRRRRRRRRRR
RRRRRR2RRRRRRRRRRRRRRRRRRRRRRR
RRRRRRRRRfgRRRRRRRRRRRR0R0RRRR
8RRR3RRRRRRRRRRRRRRRRRRRY?RRRR
RRRRRRRZRRRRRRRRR2RRRRRRRRRRRR
RRRRRRRRRRRRRRRRRRRRRRRRRRRRRR
RRRRRRRRRRRRR8RRZRRRRRRRRR1RRR
RRRRRRRRRRR1RRR2RRRRRRRRRRRRRR
RRRRRRRRR2RRRRRRRR1RRRRR82RRRR
R8RR1RRR2RRR8RRRRRRRRR2RRRRRRR
RRRRRRRRRRRRRRRRRRRRRRRRRR1RRR
RRR2RRRRRRR1RRRRRRRRRRRRRRRRRR
