RRRRRR0RRR
RRRPRRRRRR
RRRRRRRRRR
RRRRRRRRPR
RRRRRRRRRR
RRRRRRRRRR
RPRRRRRRRR
RRRRRRRRRR
RRRRRRRRRR
RRRR9RRRRR
