777777777777777777777777777777
777777777777777777777777777777
777777777FFFFFFF77777777777777
777777FFFF77777FFF777777777777
777777F7777777777F777@77777777
7777777F777777777F777@77777777
7777777F777777777FGG@@77777777
77777777F7G777777F7@@G77777777
777777777FG777777F@@7G77777777
777777777FF777777F@777G7777777
77777777GGFF7777@@77GGG7777777
777777GGGGG7FFFG@GGGG777777777
7777GGGG777777@F77777777777777
7777GGG7777777@777777777777777
777777777777777777777777777777
777777777777777777777777777777
777777777777777777777777777777
777777777777777777777777777777
777777777777777777777777777777
777777777777777777777777777777
777777777777777777777777777777
777777777777777777777777777777
777777777777777777777777777777
777777777777777777777777777777
777777777777777777777777777777
777777777777777777777777777777
777777777777777777777777777777
777777777777777777777777777777
777777777777777777777777777777
777777777777777777777777777777
