@@@@@@@@@@@@@@@@@@@@
@FFFFFFFFFFFFFFFFFF@
@FFFFFFFFFFFFFFFFFF@
@FFFFFFFFFFFFFFFFFF@
@FFFFFFFFFFFFFFFFFF@
@FFFFFFFFFFFFFFFFFF@
@FFFFFFFFFFFFFFFFFF@
@FFFFFFFFFFFFFFFFFF@
@FFFFFFFFFFFFFFFFFF@
@FFFFFFFFFFFFFFFFFF@
@bbhhbbbbbbbbbbbbbb@
@jFFFFFFFFFFFFFFFFF@
@FFFFFFFFFFFFFFFFFF@
@FFFFFFFFF@FFFFFFFF@
@FFFFFFFFF@FFFFFFFF@
@FFFFFFFFF@FFFFFFFF@
@FFFFFFFFF@FFFFFFFF@
@FFFFFFFFF@FFFFFFFF@
@FFFFFFFFF@FFFFFFFF@
@@@@@@@@@@@@@@@@@@@@
$
0 0 20 8 4 5
