cccccccccccccccccccccccccccccccccccccccccccccccccccccccccccccccccccccccccccccccccccccc
c                  c                      cc                  c                      c
c                  c   c                  cc                  c                      c
c                  c                      cc                  c                      c
c        e         c       c              cc                  c                      c
c                  c        c        ccccccc                  c                      c
c                  c                      cc                  c                      c
c                  c                      cc                  c                      c
cccccccccccccccccccccccccccccccccccccccccccccccccccccccccccccccccccccccccccccccccccccc
c                  c                      cc                  c                      c
c            ccccccc                      cc                  c                      c
c                  c                      cc                  c                      c
c                  c         c            cc                  c                      c
c                  c                      cc                  c                      c
c                  c                      cc                  c                      c
c                  c                      cc                  c                      c
c                  c                      cc                  c                      c
c                  c                      cc                  c                      c
cccccccccccccccccccccccccccccccccccccccccccccccccccccccccccccccccccccccccccccccccccccc
c                  c                      cc                  c                      c
c                  c                      cc                  c                      c
c                  c                      cc                  c                      c
c                  c                      cc                  c                      c
c                  c                      cc                  c                      c
c                  c                      cc                  c                      c
c                  c                      cc                  c                      c
c                  c                      cc                  c                      c
c                  c                      cc                  c                      c
c                  c                      cc                  c                      c
cccccccccccccccccccccccccccccccccccccccccccccccccccccccccccccccccccccccccccccccccccccc
