777777;44444444;77777777777777
777777A44444444A77777777777777
777777A44444444A77777770111127
777777A444:4444A77777776737787
77777777777777777777777<====>7
77777777777777777777777CCCCCC7
777777777777777777377777777777
777777778777677777777777777777
777777778777677777777777777777
========>777<=================
CCCCCCCCC777CCCCCCCCCCCCCCCCCC
HHHHHHHHH77777777HHHHHHHHHHHHH
HHHHHHHHH77777777777HHHHHHHHHH
IHHHHHHHH7777777777777HHHHHHHH
HHHHHHH77777777777777777HHHHHH
HHHHH7777777777777777777777HHH
HHHH77777777777777777777777777
HHH777777777777777777777777777
HH7777777777777777777777777777
H77777777777777777777777777777
H77777777777777777777777777777
777777777777777777777777777777
777777777777777777777777777777
777777777777777777777777777777
777777777777777777777777777777
777777777777777777777777777777
777777777777777777777777777777
777777777777777777777777777777
777777777777777777777777777777
777777777777777777777777777777
